county,id_old,id,mpo,pop10,births10,deaths10,natinc10,immig10,dommig10,pop17,births17,deaths17,natinc17,immig17,dommig17,pop21,births21,deaths21,natinc21,immig21,dommig21
Alameda,6001,0500000US06001,ABAG,1515354,4873,2157,2716,2081,286,1650818,19443,10112,9331,12421,-8110,1671741,17296,11592,5704,1558,-17221
Alpine,6003,0500000US06003,non-MPO,1175,3,3,0,0,0,1141,4,13,-9,1,-1,1181,13,33,-20,0,2
Amador,6005,0500000US06005,non-MPO,38069,78,100,-22,2,-2,37050,306,437,-131,20,-20,40316,272,503,-231,6,35
Butte,6007,0500000US06007,non-MPO,220193,622,551,71,63,59,226470,2476,2406,70,191,1448,201158,1983,2476,-493,-35,-9530
Calaveras,6009,0500000US06009,non-MPO,45535,75,118,-43,2,-2,44609,371,509,-138,35,-35,45111,360,586,-226,4,56
Colusa,6011,0500000US06011,non-MPO,21465,69,23,46,16,-16,22580,313,161,152,126,-126,22059,292,193,99,18,116
Contra Costa,6013,0500000US06013,ABAG,1051669,3008,1704,1304,673,667,1138039,12257,7844,4413,5602,-1308,1163765,11795,9109,2686,1172,-6762
Del Norte,6015,0500000US06015,non-MPO,28389,91,72,19,3,-243,26858,311,310,1,29,-128,27529,258,376,-118,3,-101
El Dorado,6017,0500000US06017,SACOG,181008,381,321,60,39,-149,186123,1597,1575,22,212,1804,191992,1472,1855,-383,43,1050
Fresno,6019,0500000US06019,non-MPO,932501,3893,1539,2354,493,-796,999929,15020,7034,7986,2805,1066,1013744,13830,9561,4269,561,54
Glenn,6021,0500000US06021,non-MPO,28182,107,47,60,12,-12,29210,378,252,126,66,-66,29007,358,300,58,12,115
Humboldt,6023,0500000US06023,non-MPO,134998,383,298,85,10,280,136113,1478,1377,101,129,-1,135467,1262,1496,-234,25,-838
Imperial,6025,0500000US06025,SCAG,175200,689,215,474,294,-96,188650,2960,1049,1911,1843,-1624,177052,2396,1889,507,287,-2279
Inyo,6027,0500000US06027,non-MPO,18539,41,48,-7,6,-6,18592,182,248,-66,20,-20,18931,173,241,-68,3,19
Kern,6029,0500000US06029,non-MPO,841537,3485,1316,2169,396,-659,898825,13641,6101,7540,2436,927,908283,12363,8349,4014,474,-3226
Kings,6031,0500000US06031,non-MPO,152163,568,192,376,63,-1258,150587,2236,838,1398,301,-284,153617,2242,1206,1036,66,-570
Lake,6033,0500000US06033,non-MPO,64953,161,191,-30,11,307,64979,747,911,-164,81,350,68082,713,903,-190,15,158
Lassen,6035,0500000US06035,non-MPO,34784,84,72,12,0,-123,30652,325,216,109,6,-62,31377,293,323,-30,4,-622
Los Angeles,6037,0500000US06037,SCAG,9838771,31725,13677,18048,8343,-6225,10271792,122252,62857,59395,55783,-58489,9944953,97884,88887,8997,6960,-83478
Madera,6039,0500000US06039,non-MPO,150145,574,276,298,51,-1069,157472,2333,1116,1217,271,466,156654,2099,1458,641,53,-559
Marin,6041,0500000US06041,ABAG,252286,588,472,116,102,-341,262545,2242,1958,284,717,-1162,260416,2080,2207,-127,131,-1998
Mariposa,6043,0500000US06043,non-MPO,18245,30,36,-6,2,-2,17996,147,208,-61,20,-20,17044,120,220,-100,2,19
Mendocino,6045,0500000US06045,non-MPO,87667,303,201,102,29,-305,89124,1016,832,184,153,8,90806,879,1068,-189,29,-636
Merced,6047,0500000US06047,non-MPO,256810,1067,373,694,146,177,276275,4087,1835,2252,699,1038,283193,3750,2382,1368,134,818
Modoc,6049,0500000US06049,non-MPO,9689,27,24,3,2,-2,9521,116,101,15,4,-4,8592,75,131,-56,2,-57
Mono,6051,0500000US06051,non-MPO,14007,32,13,19,3,-217,13798,134,56,78,20,-101,13073,123,59,64,4,-180
Monterey,6053,0500000US06053,non-MPO,414945,1672,546,1126,299,-1537,442808,6170,2578,3592,1367,-2096,439703,5593,3326,2267,257,-1829
Napa,6055,0500000US06055,ABAG,136281,390,305,85,70,-358,141624,1395,1296,99,462,-506,137600,1202,1298,-96,81,-818
Nevada,6057,0500000US06057,non-MPO,98526,215,217,-2,11,-247,98433,777,1049,-272,110,295,102033,772,1218,-446,13,74
Orange,6059,0500000US06059,SCAG,3014677,9296,4251,5045,2488,-3088,3200748,37866,19836,18030,17568,-13972,3161681,30969,26320,4649,2770,-30251
Placer,6061,0500000US06061,SACOG,350040,951,680,271,102,1235,381675,3710,3300,410,612,4848,409044,3487,3774,-287,154,3869
Plumas,6063,0500000US06063,non-MPO,19982,41,66,-25,-1,1,19481,168,222,-54,12,-12,19659,163,257,-94,-1,88
Riverside,6065,0500000US06065,SCAG,2196083,7214,3391,3823,1019,1600,2389723,30441,16404,14037,6285,9813,2431647,27035,23971,3064,1125,5978
Sacramento,6067,0500000US06067,SACOG,1421458,5023,2475,2548,893,-771,1519381,19478,11649,7829,6550,1466,1586031,18009,13903,4106,2295,-6036
San Benito,6069,0500000US06069,non-MPO,55401,192,60,132,23,-23,58416,774,368,406,153,-153,64924,728,438,290,35,489
San Bernardino,6071,0500000US06071,SCAG,2043484,7470,2997,4473,910,2891,2163680,30929,14225,16704,5703,-2305,2181258,26744,21681,5063,1148,-6936
San Diego,6073,0500000US06073,SANDAG,3101036,10714,4663,6051,2485,-2813,3320108,42291,21555,20736,17572,-14016,3288455,37217,26659,10558,1898,-27737
San Francisco,6075,0500000US06075,ABAG,809753,2117,1302,815,1684,2019,880418,9004,5758,3246,7041,-2332,855550,8002,6701,1301,802,-17538
San Joaquin,6077,0500000US06077,non-MPO,687992,2546,1155,1391,547,748,749092,10176,5609,4567,2896,3286,786700,9717,7533,2184,677,3163
San Luis Obispo,6079,0500000US06079,non-MPO,269031,700,561,139,58,-803,278532,2561,2519,42,375,35,278607,2359,2639,-280,55,-4164
San Mateo,6081,0500000US06081,ABAG,720695,2284,1164,1120,679,445,772900,8902,4821,4081,4808,-4496,756655,7734,5185,2549,873,-10264
Santa Barbara,6083,0500000US06083,non-MPO,423567,1509,711,798,210,-1336,450216,5463,3256,2207,1506,-806,443121,5337,3696,1641,-106,-7073
Santa Clara,6085,0500000US06085,ABAG,1790185,5861,2185,3676,2116,2751,1945465,22860,10218,12642,17424,-17428,1913113,19547,11896,7651,2124,-30178
Santa Cruz,6087,0500000US06087,non-MPO,262425,809,397,412,136,-505,276452,2782,1779,1003,951,-1256,267551,2186,2095,91,57,-4957
Shasta,6089,0500000US06089,non-MPO,177125,533,490,43,21,-162,178501,2039,2367,-328,153,1045,182072,1845,2607,-762,26,927
Sierra,6091,0500000US06091,non-MPO,3233,7,14,-7,1,-1,3133,26,34,-8,1,-1,3217,26,45,-19,0,3
Siskiyou,6093,0500000US06093,non-MPO,44862,90,128,-38,9,-9,44239,480,614,-134,27,-27,43790,390,702,-312,7,4
Solano,6095,0500000US06095,ABAG,412525,1187,710,477,253,-1549,437309,5224,3368,1856,1403,638,452532,4952,3932,1020,281,-2174
Sonoma,6097,0500000US06097,ABAG,483541,1417,993,424,183,-944,503883,4930,4254,676,1163,-1108,485110,4311,4606,-295,210,-4685
Stanislaus,6099,0500000US06099,non-MPO,515940,1922,927,995,274,218,551557,7817,4378,3439,1840,2686,553138,7088,5798,1290,426,-2573
Sutter,6101,0500000US06101,SACOG,94859,325,198,127,126,-131,98720,1354,855,499,534,-521,101478,1255,947,308,116,303
Tehama,6103,0500000US06103,non-MPO,63505,180,138,42,11,-11,64294,782,646,136,53,-53,65873,724,875,-151,15,366
Trinity,6105,0500000US06105,non-MPO,13779,35,42,-7,1,-1,13455,114,151,-37,5,-5,16047,99,177,-78,2,-12
Tulare,6107,0500000US06107,non-MPO,442330,1852,688,1164,226,-1239,472748,7111,3030,4081,1199,-492,474998,6676,4162,2514,211,-1209
Tuolumne,6109,0500000US06109,non-MPO,55350,130,145,-15,4,-4,54036,454,709,-255,39,-39,54811,398,766,-368,6,-327
Ventura,6111,0500000US06111,SCAG,824441,2766,1240,1526,418,-821,856111,9528,5784,3744,2177,-3483,837845,8287,7347,940,376,-8016
Yolo,6113,0500000US06113,SACOG,202385,565,259,306,122,1108,219468,2411,1357,1054,1322,366,217136,1957,1527,430,-63,225
Yuba,6115,0500000US06115,SACOG,72315,282,122,160,24,-24,76691,1233,680,553,128,-128,82091,1121,761,360,23,240
